+-+-+-+-+-+-+-+
| |       |   |
+ + +-+-+ +-+ +
|   |   |   | |
+ + + + +-+ + +
| | | | | |   |
+ +-+-+ + +-+ +
| |    S|   | |
+ + +-+ +-+ + +
| |   |     | |
+ +-+ +-+-+ + +
|   |     |   |
+ + +-+-+ +-+-+
| |     |     |
+-+-+-+ +-+-+-+